SO textures/eagle.xpm
WE textures/bluestone.xpm
EA textures/purplestone.xpm
NO textures/wood.xpm
F 220,100,255
C 85,107,47


1111
1001
10N1
1111