SO textures/eagle.xpm
WE textures/eagle.xpm
EA textures/eagle.xpm
NO textures/eagle.xpm
F 220,100,255
C 225,30,001

111111111
101111101
1110N0111
111000111
10001011
10001101
11111111
111
