SO textures/eagle.xpm
WE textures/bluestone.xpm
EA textures/purplestone.xpm
NO textures/wood.xpm
F 135,206,235
C 85,107,47


1111 1111111111
100111000000001
100000000111111
1000000001
1000000001
100000000111111
100000000000001
111111100000001111111
      100000000000001
      100000000000001
      100000000000001
      100010100000001
1111111000111000000011111111111111111111
100000000000000000000000000W000000000001
1000000111000000000000000000000000000001
10000001 1000000000000000000000000000001
10000001 1000000000000000000000100000001
11111111 1111111111100111111111111111111
            1000000000001
            1000000000001
            100000000000111111111111111111111111111
            100000000000000000000000000000000000001
            100000000000000000000111111111111111111
            1000000000001111111111
            1111111111111